AB#######
#C#######
#DEB#####
###C#####
###C#####
###C#####
###DEEEB#
#######C#
#######C#
#######C#
#######C#
#######DF
