@..#......#.....
. .....T..#.....
######..........
.....#.T..#.....
.....#....#.....
.....#######.###
.....#..........
....... .. .####
......T.....#..x
.....#......#...
.....#......#...
.....########...
................
................
................
................
