................
................
........ .......
........ .......
.........####...
........ ...#...
####.  . ...#.T.
...#.... ...#...
...#........T..x
...#........#...
...#.... ...#...
...#.... ...#...
...#.... ...#...
...#####  ####T#
................
................
