..... ..@...#...
............T...
..... ......#...
#. .#########...
............#...
............#...
#########.T.#...
..#.....#...#...
..#.....#. .#..x
..#..#..#...#...
.....#... . #..T
.....#......#...
..###########...
................
................
................
