................
...... .........
............. ..
...... .........
...########   ##
. .#........T...
...#............
...#............
@..#####...#####
...#............
####............
................
................
.......T.T......
................
........x.......
