...T..#.@.#.....
. ....#...#.....
. .T..#. .#.....
. .#..#. .#..#..
...#.... .#..#..
.. #......#..#..
.. ########..#..
.. ........T.#..
.............#..
##############..
................
........   .   .
................
#######...######
................
........x.......
