................
................
..#####.........
......####.##T##
......#.....#...
####..#.T...#...
......#..####...
......#..#..#...
@.....#..#.....Q
......#..#..#...
......#..#..#...
#######. #..####
........ #......
..T#######......
................
................
